4 4 4 4 4 4 4 4 4 4 4 4 4 4 4 4 4 4 4 4 4
4 0 0 0 0 0 0 0 0 0 0 0 0 0 0 0 0 0 0 0 4
4 0 6 8 7 0 6 8 7 0 0 0 6 8 7 0 6 8 7 0 4
4 0 9 0 10 0 9 0 10 0 0 0 9 0 10 0 9 0 10 0 4
4 0 2 5 3 0 2 5 3 0 0 0 2 5 3 0 2 5 3 0 4
4 0 0 0 0 0 0 0 0 0 0 0 0 0 0 0 0 0 0 0 4
4 0 32 34 34 34 34 34 33 0 0 0 35 37 37 37 37 37 36 0 4
4 0 32 34 34 34 34 34 33 0 0 0 35 37 37 37 37 37 36 0 4
4 0 11 27 27 27 27 27 12 0 0 0 13 25 25 25 25 25 14 0 4
4 0 0 0 0 0 0 0 0 0 0 0 0 0 0 0 0 0 0 0 4
4 0 47 46 46 46 46 46 48 0 0 0 29 31 31 31 31 31 30 0 4
4 0 47 46 46 46 46 46 48 0 0 0 29 31 31 31 31 31 30 0 4
4 0 15 26 26 26 26 26 16 0 0 0 17 28 28 28 28 28 18 0 4
4 0 0 0 0 0 0 0 0 0 0 0 0 0 0 0 0 0 0 0 4
4 0 41 40 40 40 40 40 42 0 0 0 44 43 43 43 43 43 45 0 4
4 0 41 40 40 40 40 40 42 0 0 0 44 43 43 43 43 43 45 0 4
4 0 19 24 24 24 24 24 20 0 0 0 21 23 23 23 23 23 22 0 4
4 0 0 0 0 0 0 0 0 0 0 0 0 0 0 0 0 0 0 0 4
4 4 4 4 4 4 4 4 4 4 4 4 4 4 4 4 4 4 4 4 4